##########
#........#
#.@......#
#........#
#....t...#
#........#
#..^.....#
#........#
#........#
##########